1 3 1
9 3
10 7
-1 -1 07 08 08 08 08 09 -1 -1
-1 -1 11 00 00 00 00 12 -1 -1
30 08 06 00 00 00 00 10 08 31
24 23 23 00 00 00 00 23 23 25
28 03 01 00 00 00 00 05 03 29
-1 -1 11 23 23 23 23 12 -1 -1
-1 -1 02 03 03 03 03 04 -1 -1
4
0 3 5 2 4
0 4 1 0 4
0 5 5 2 4
0 6 1 0 4
0